111111111111111111111111
1000C0000010000000000001
1000110000100C0000000001
100011000011111000E00001
1000000X0000000000000001
1000P000000000CX00000001
100000000C00000011111111
10000C00000000001X00C001
1000X0000C00000000001001
111111111111111111111111